{
  "_name": "Bombs part 3",
  "_fileName": "Bombs_3",
  "_bricks": [
    0, 0, 0, 0, 2, 0, 0, 0, 0,
    0, 0, 0, 0, 2, 0, 0, 0, 0,
    0, 0, 0, 0, 2, 0, 0, 0, 0,
    0, 0, 0, 0, 2, 0, 0, 0, 0,
    0, 0, 0, 0, 2, 0, 0, 0, 0,
    0, 0, 0, 0, 2, 0, 0, 0, 0,
    0, 0, 0, 0, 2, 0, 0, 0, 0,
    0, 0, 0, 0, 103, 0, 0, 0, 0,
    2, 2, 2, 2, 102, 2, 2, 2, 2
  ],
  "_n": 9,
  "_m": 9,
  "_brickHeight": 0.25,
  "_leftOffset": 0.1,
  "_rightOffset": 0.1,
  "_offsetBetweenRows": 0.01,
  "_offsetBetweenCols": 0.01
}