{
  "_name": "God Level",
  "_fileName": "GodLevel",
  "_bricks": [
    3, 3, 3, 3, 3, 3, 3, 3, 3,
    2, 2, 2, 2, 2, 2, 2, 2, 2,
    0, 0, 0, 400, 401, 0, 0, 0, 0,
    300, 301, 302, 303, 2, 2, 2, 2, 2,
    0, 0, 0, 0, 0, 0, 0, 0, 0,
    200, 201, 202, 203, 2, 2, 2, 2, 2,
    0, 0, 0, 0, 0, 0, 0, 0, 0,
    100, 101, 102, 103, 2, 2, 2, 2, 2,
    1, 1, 1, 0, 0, 0, 1, 1, 1
  ],
  "_n": 9,
  "_m": 9,
  "_brickHeight": 0.25,
  "_leftOffset": 0.01,
  "_rightOffset": 0.01,
  "_offsetBetweenRows": 0.01,
  "_offsetBetweenCols": 0.01
}