{
  "_name": "Level 6",
  "_fileName": "Level6",
  "_bricks": [
    0, 1, 3, 3, 3, 2, 2, 0, 0,
    0, 1, 2, 3, 2, 3, 2, 3, 0,
    0, 1, 3, 3, 3, 2, 2, 0, 0,
    0, 1, 0, 0, 0, 0, 0, 0, 0,
    0, 1, 0, 0, 0, 0, 0, 0, 0,
    2, 1, 2, 202, 202, 202, 202, 202, 202,
    2, 1, 2, 2, 2, 2, 2, 2, 2,
    2, 0, 0, 0, 2, 0, 0, 0, 2,
    2, 0, 0, 0, 2, 0, 0, 0, 2
  ],
  "_n": 9,
  "_m": 9,
  "_brickHeight": 0.25,
  "_leftOffset": 0.1,
  "_rightOffset": 0.1,
  "_offsetBetweenRows": 0.01,
  "_offsetBetweenCols": 0.01
}