{
  "_name": "Level 5",
  "_fileName": "Level5",
  "_bricks": [
    0, 0, 0, 0, 0, 0, 0, 0, 0,
    0, 3, 3, 3, 3, 3, 0, 0, 0,
    3, 2, 2, 202, 2, 3, 3, 0, 0,
    3, 2, 202, 201, 202, 2, 3, 3, 0,
    3, 2, 2, 202, 2, 2, 2, 2, 3,
    3, 3, 3, 3, 3, 3, 3, 3, 3,
    0, 2, 2, 2, 0, 2, 2, 2, 0,
    0, 2, 1, 2, 0, 2, 1, 2, 0,
    0, 2, 2, 2, 0, 2, 2, 2, 0
  ],
  "_n": 9,
  "_m": 9,
  "_brickHeight": 0.25,
  "_leftOffset": 0.1,
  "_rightOffset": 0.1,
  "_offsetBetweenRows": 0.01,
  "_offsetBetweenCols": 0.01
}