{
  "_name": "Level 8",
  "_fileName": "Level8",
  "_bricks": [
    3, 0, 0, 0, 0, 0, 0, 0, 3,
    3, 2, 3, 2, 102, 2, 3, 2, 3,
    3, 3, 2, 3, 103, 3, 2, 3, 3,
    3, 2, 3, 2, 103, 2, 3, 2, 3,
    3, 3, 3, 0, 103, 0, 3, 3, 3,
    3, 2, 3, 2, 103, 2, 3, 2, 3,
    3, 3, 2, 3, 103, 3, 2, 3, 3,
    3, 2, 3, 2, 102, 2, 3, 2, 3,
    1, 0, 1, 0, 0, 0, 1, 0, 1
  ],
  "_n": 9,
  "_m": 9,
  "_brickHeight": 0.25,
  "_leftOffset": 0.1,
  "_rightOffset": 0.1,
  "_offsetBetweenRows": 0.01,
  "_offsetBetweenCols": 0.01
}