{
  "_name": "Level 1",
  "_fileName": "Level1",
  "_bricks": [
    2, 2, 2, 2, 400, 2, 2, 2, 2,
    2, 0, 0, 0, 0, 0, 0, 0, 2,
    2, 0, 0, 201, 401, 201, 0, 0, 2,
    2, 0, 0, 3, 3, 3, 0, 0, 2,
    2, 200, 0, 3, 100, 3, 0, 200, 2,
    2, 0, 0, 3, 3, 3, 0, 0, 2,
    2, 0, 0, 2, 201, 2, 0, 0, 2,
    2, 0, 0, 2, 0, 2, 0, 0, 2,
    2, 2, 2, 2, 0, 2, 2, 2, 2
  ],
  "_n": 9,
  "_m": 9,
  "_brickHeight": 0.25,
  "_leftOffset": 0.1,
  "_rightOffset": 0.1,
  "_offsetBetweenRows": 0.01,
  "_offsetBetweenCols": 0.01
}