{
  "_name": "Level 4",
  "_fileName": "Level4",
  "_bricks": [
    0, 0, 0, 0, 103, 0, 0, 0, 0,
    0, 3, 3, 3, 101, 2, 2, 2, 0,
    0, 3, 0, 0, 200, 0, 0, 2, 0,
    0, 3, 0, 0, 200, 0, 0, 2, 0,
    0, 202, 203, 202, 200, 202, 203, 202, 0,
    0, 201, 0, 0, 0, 0, 0, 201, 0,
    2, 2, 2, 0, 0, 0, 2, 2, 2,
    2, 3, 2, 0, 0, 0, 2, 3, 2,
    2, 3, 2, 0, 0, 0, 2, 3, 2
  ],
  "_n": 9,
  "_m": 9,
  "_brickHeight": 0.25,
  "_leftOffset": 0.1,
  "_rightOffset": 0.1,
  "_offsetBetweenRows": 0.01,
  "_offsetBetweenCols": 0.01
}