{
  "_name": "Level 9",
  "_fileName": "Level9",
  "_bricks": [
    3, 0, 0, 0, 0, 0, 0, 0, 3,
    3, 2, 3, 2, 200, 2, 3, 2, 3,
    3, 3, 3, 0, 201, 0, 3, 3, 3,
    3, 2, 3, 2, 200, 2, 3, 2, 3,
    3, 3, 3, 3, 201, 3, 3, 3, 3,
    3, 2, 3, 2, 301, 2, 3, 2, 3,
    3, 3, 3, 0, 303, 0, 3, 3, 3,
    3, 2, 3, 2, 301, 2, 3, 2, 1,
    1, 1, 1, 1, 0, 1, 1, 1, 1
  ],
  "_n": 9,
  "_m": 9,
  "_brickHeight": 0.25,
  "_leftOffset": 0.1,
  "_rightOffset": 0.1,
  "_offsetBetweenRows": 0.01,
  "_offsetBetweenCols": 0.01
}