{
  "_name": "Level 7",
  "_fileName": "Level7",
  "_bricks": [
    1, 0, 0, 0, 0, 0, 0, 0, 1,
    1, 2, 3, 2, 0, 2, 3, 2, 1,
    1, 3, 2, 3, 0, 3, 2, 3, 1,
    1, 2, 3, 2, 0, 2, 3, 2, 1,
    1, 1, 1, 0, 0, 0, 1, 1, 1,
    1, 2, 3, 2, 0, 2, 3, 2, 1,
    1, 3, 2, 3, 0, 3, 2, 3, 1,
    1, 2, 3, 2, 0, 2, 3, 2, 1,
    1, 0, 0, 0, 0, 0, 0, 0, 1
  ],
  "_n": 9,
  "_m": 9,
  "_brickHeight": 0.25,
  "_leftOffset": 0.1,
  "_rightOffset": 0.1,
  "_offsetBetweenRows": 0.01,
  "_offsetBetweenCols": 0.01
}